somewhere, anywhere	どこか	lesson1 unit1
anywhere, nowhere	どこも	lesson1 unit1
Canada	カナダ	lesson1 unit1
something, anything	なにか	lesson1 unit1
would (it) be good	いいでしょうか	lesson1 unit1
yukata / cotton kimono	ゆかた	lesson1 unit1
recently	さいきん	lesson1 unit1
be popular, be fashionable	にんきがあります	lesson1 unit1
~the alternative of...	〜の　ほうが	lesson1 unit1
later	あとで	lesson1 unit1
try asking	きいてみます	lesson1 unit1
try and see how it goes	〜てみます	lesson1 unit1
~than	〜より	lesson1 unit1
which	どちら	lesson1 unit1
Russia	ロシア	lesson1 unit1
Brazil	ブラジル	lesson1 unit1
Portugal	ポルトガル	lesson1 unit1
number one	いちばん	lesson1 unit1
high, tall, expensive	たかい	lesson1 unit1
list	リスト	lesson1 unit1
which month	なんがつ	lesson1 unit1
rain	あめ	lesson1 unit1
few, not many, little, not much	すくない	lesson1 unit1
shoe	くつ	lesson1 unit1
put on (shoes, pants, etc. over the feet)	はきます	lesson1 unit1
wear, put on (clothes - shirt, sweater, jacket, etc.)	きます	lesson1 unit1
t-shirt	Tシャツ	lesson1 unit1
cell phone case	けいたいケース	lesson1 unit1
address book	アドレスちょう	lesson1 unit1
key holder	キーホルダー	lesson1 unit1
mouse pad	マウスパッド	lesson1 unit1
calendar	カレンダー	lesson1 unit1
mug	マグカップ	lesson1 unit1
plate	(お)さら	lesson1 unit1
people at the office	かいしゃのひと	lesson1 unit1
cookie	クッキー	lesson1 unit1
both, either	どちらも	lesson1 unit1
both	りょうほう	lesson1 unit1
each	~ずつ	lesson1 unit1
in various ways	いろいろ	lesson1 unit1
to be crowded	こんでいる／こんでいます	lesson1 unit1
become crowded	こむ／こみます	lesson1 unit1
shopping	かいもの	lesson1 unit1
weekday	へいじつ	lesson1 unit1
here (where I am)	こちら	lesson1 unit1
cola	コーラ	lesson1 unit1
company employee	しゃいん	lesson1 unit1
food	たべもの	lesson1 unit1
like very much	だいずき	lesson1 unit1
rice ball	おにぎり	lesson1 unit1
overseas	かいがい	lesson1 unit1
geared toward, for (suffix)	~むけ	lesson1 unit1
development	かいはつ	lesson1 unit1
to make; to prepare	つくる (作る／作ります)	?
come	来	kanji
week	週	kanji
go	行	kanji
year	年	kanji
what<br />	何	kanji
spirit, mind	気	kanji
<br />two	二<br />二つ<br />二人<br />	kanji
<br />five	五<br />五つ<br />五人	kanji
<br />nine	九<br />九つ<br />九月	kanji
hundred	百	kanji
low, short	ひくい	lesson2 unit1
soft	やらわかい	lesson2 unit1
hard	かたい	lesson2 unit1
wide	ふとい	lesson2 unit1
thin, narrow<br />	ほそい	lesson2 unit1
long	ながい	lesson2 unit1
short	みじかい	lesson2 unit1
thick	あつい	lesson2 unit1
thin (of cloth, paper, etc.)	うすい	lesson2 unit1
light, lightweight	かるい	lesson2 unit1
heavy<br />	おもい	lesson2 unit1
colorful, gaudy	はでな	lesson2 unit1
plain, subdued	じみな	lesson2 unit1
cute	かわいい	lesson2 unit1
simple	シンプルな	lesson2 unit1
salesperson, clerk	てんいん	lesson2 unit1
I would like to buy...	買いたいんですが	lesson2 unit1
this, this one (here) (polite)	こちら	lesson2 unit1
uh..., hmm...	あのう	lesson2 unit1
tall	せが高い	lesson2 unit1
height, stature	せ	lesson2 unit1
about like this	このぐらい	lesson2 unit1
oh, I see	ああ	lesson2 unit1
person (polite form)	かた	lesson2 unit1
size	サイズ	lesson2 unit1
I will take that one	それにします	lesson2 unit1
For use as a present	プレゼント用	lesson2 unit1
for use as	-you (〜用)	lesson2 unit1
wrap	つつみます	lesson2 unit1
how about this one?	いかがですか	lesson2 unit1
fast	はやい (早い)	lesson2 unit1
public bath/hot spring	温泉	?
confections; sweets; candy	おかし	?
post card	えはがき	?
new	atarashii (新しい)	?
cheap	安い	?
skilled	上手	?
golf	ゴルフ	
study	べんきょうします	
friends	ともだち	
room	へや	lesson1 unit1
service	サービス	lesson2 unit1
train station	駅	
foreigners	がいこくじん	lesson2 unit1
spacious	ひろい	lesson2 unit1
visitor	おきゃくさん	
dessert	デサート	lesson1 unit1
Monday	月曜日	
Wednesday	水曜日	
Thursday	木曜日	
Friday	金曜日	
Saturday	土曜日	
fitting room<br />	しちゃくしつ	lesson2 unit1
never mind	いいです	lesson2 unit1
same	おなじ	lesson2 unit1
medium size	Mサイズ	lesson2 unit1
sold out	うりきれ	lesson2 unit1
go/come in, enter	入ります	lesson2 unit1
display	デイスプレイ	lesson2 unit1
payment	(お)しはらい	lesson2 unit1
cash	げんきん	lesson2 unit1
credit card	クレジットカード	lesson2 unit1
I'm very sorry	もうしわけございまえん	?
that way; over there	あちら	?
siblings, brothers and sisters	兄弟	lesson2 unit1
younger brother	おとうと (弟)	lesson2 unit1
younger sister	いもうと (妹)	lesson2 unit1
older sister	あね (姉)	lesson2 unit1
older brother	あに (兄)	lesson2 unit1
colleague	どうりょう	lesson2 unit1
in that case, then, well	では	
favor, request	おねがい	
please bring me the check	おしはらい　おねがい	
superior	じょうし	lesson2 unit1
junior staff	ぶか	lesson2 unit1
assistant	アシスタント	lesson2 unit1
apartment manager	マンションの　かんり人	lesson2 unit1
next door neighbor	となりの人<br />	lesson2 unit1
teacher	先生	lesson2 unit1
Vancouver	バンクーバー	
suburbs	こうがい	lesson2 unit1
quit	やめます	lesson2 unit1
fishing	つり	lesson2 unit1
recipe	レシピ	lesson2 unit1
both of them	二人とも	lesson2 unit1
player, athlete	せんしゅ	lesson2 unit1
model	モデル	lesson2 unit1
four seasons	しき	lesson2 unit1
wow	うわあ	lesson2 unit1
firm; company	しょうかい	?
screen	スクリーン	lesson2 unit1
rental shop	レンタルシップ	lesson2 unit1
basketball	バスケットボール	lesson2 unit1
borrow, rent	借ります	lesson2 unit1
before	前に	lesson3 unit1
paper bag	かみぶくろ (紙袋)	lesson3 unit1
paper	かみ (紙)	lesson3 unit1
bag, sack	ぶくろ (袋)	lesson3 unit1
forget	わすれます	lesson3 unit1
some, a number of, several	いくつか	lesson3 unit1
be in/inside	入っています	lesson3 unit1
general area	あたり	lesson3 unit1
might it be	でしょうか	lesson3 unit1
oh good! (speaking to oneself)	ああ、よかった	lesson3 unit1
from now, right away	今から	lesson3 unit1
go and get	取りに行きます	lesson3 unit1
package	パッケージ	lesson3 unit1
new product	しんしょうひん	lesson3 unit1
new (prefix)	新	lesson3 unit1
someone, anyone	だれか	lesson1 unit1
sometime	いつか	lesson1 unit1
beverage	のみもの	lesson1 unit1
example	れい	lesson1 unit1
lesson	レッソン	lesson1 unit1
project	プロジェクト	lesson1 unit1
chief	チーフ	lesson1 unit1
it rains a lot	あめが　おおい	lesson1 unit1
it does not rain much	あめが　すくない	lesson1 unit1
smoked salmon	スモークサーモン	lesson1 unit1
foreign country	がいこく	lesson2 unit1
one size	ワンサイズ	lesson2 unit1
day	ひ	lesson2 unit1
that presents	ーしょうかい	lesson2 unit1
to sit	あわります	lesson3 unit1
attach (to), come with	つきます	lesson3 unit1
box	はこ	lesson3 unit1
safe	きんこ	lesson3 unit1
apartment	アパート	lesson3 unit1
document	しょるい	lesson3 unit1
tag	なふだ	lesson3 unit1
french fry	フライドポテト	lesson3 unit1
box lunch	（お）べんと	lesson3 unit1
visit (lit. play)	あそびます	lesson3 unit1
glasses	めがね	lesson3 unit1
gloves	てぶくろ	lesson3 unit1
document envelope	しょるいふくろ	lesson3 unit1
wristwatch	うでどけい	lesson3 unit1
leather	かわ	lesson3 unit1
vinyl	ビニール	lesson3 unit1
wool	ウール	lesson3 unit1
bookshelf	ほんだな	lesson3 unit1
this morning	けさ	lesson3 unit1
a little (polite form)	しょうしょう	lesson3 unit1
please wait (polite form)	おまちください	lesson3 unit1
fold up, folding	おりたたみ	lesson3 unit1
just now, only a moment ago	さっき	lesson3 unit1
seat	せき	lesson3 unit1
look for, search for	さがします	lesson3 unit1
neck	くび	lesson3 unit1
arm	うで	lesson3 unit1
chest, breast	むね	lesson3 unit1
elbow	ひじ	lesson3 unit1
knee	ひざ	lesson3 unit1
hair	かみ（のけ）	lesson3 unit1
forehead	ひたい	lesson3 unit1
eyebrow	まゆ（げ）	lesson3 unit1
nose	はな	lesson3 unit1
cheek	ほお	lesson3 unit1
beard, mustache	ひげ	lesson3 unit1
ear	みみ	lesson3 unit1
mouth	くち	lesson3 unit1
cheerful	あかるい	lesson3 unit1
gentle, kind	やさしい	lesson3 unit1
energetic	げんき（な）	lesson3 unit1
mild-mannered	おとなしい	lesson3 unit1
serious	まじめ（な）	lesson3 unit1
stubborn	がんこ（な）	lesson3 unit1
strict	きびしい	lesson3 unit1
mean	いじわる（な）	lesson3 unit1
hmm..., uh...	ええと	lesson3 unit1
I know!	わかった	lesson3 unit1
something or other	なんとか	lesson3 unit1
that is right	そう そう	lesson3 unit1
at last, finally	やっと	lesson3 unit1
be able to find	みつかります	lesson3 unit1
about, concerning	～について	lesson3 unit1
end, finish	おわります	lesson3 unit1
see (someone) off	おくりに いきます	lesson3 unit1
system notebook	システムてちょう	lesson3 unit1
brown	ちゃいろ	lesson3 unit1
Argentina	アルゼンチン	lesson1 unit1
balcony	バルコニー	lesson3 unit1
cabinet (katakana)	キャビネット	lesson3 unit1
cash register	レジ	lesson3 unit1
clothing (trad. Japanese)	きもの	lesson2 unit1
desk	つくえ	lesson3 unit1
glass	グラス	lesson3 unit1
muffler; scarf	マフラー	lesson3 unit1
nothing/anything, anything	なにも	lesson1 unit1
nowhere/everywhere, anywhere	どこも	lesson1 unit1
nylon	ナイロン	lesson3 unit1
plastic	プラスチック	lesson3 unit1
shirt	シャツ	lesson3 unit1
simple; easy (na-adj)	かんたん	lesson2 unit1
suitcase	スーツケース	lesson3 unit1
teacher, doctor, professor	せんせい	lesson2 unit1
to play; also used to visit someone	あそぶ	lesson3 unit1
to put on (glasses, etc.); to hang (e.g. picture); to sit	かける	lesson3 unit1
to put on (one's head)	かぶる	lesson3 unit1
to search (for something lost)	さがす	lesson3 unit1
autumn	あき	misc unit1
autumn colours	こうよう	misc unit1
Bon holidays (festival to honor the spirits of one's ancestors)	ぼんやすみ	misc unit1
bottom	そこ	misc unit1
cicada	せみ	misc unit1
clean	きれい	misc unit1
closed	とじた	misc unit1
cold (object)	つめたい	misc unit1
cool (of weather)	すずしい	misc unit1
dark (color)	こい	misc unit1
dirty	きたない	misc unit1
dry	かわいた	misc unit1
empty	から	misc unit1
full	いっぱい	misc unit1
Girls' Festival (March 3rd)	ひなまつり	misc unit1
Golden Week	ゴールデンウイーク	misc unit1
happy	うれしい	misc unit1
humid	むしあつい	misc unit1
Japanese Year	しょうがつ	misc unit1
just right (weather)	ちょうどいい	misc unit1
light (color)	うすい	misc unit1
medium	ちゅうぐらい	misc unit1
narrow	せまい	misc unit1
off	きえている	misc unit1
open	ひらいた	misc unit1
rain season	つゆ	misc unit1
sad	かなしい	misc unit1
season	きせつ	misc unit1
slow, late	おそい	misc unit1
spring	はる	misc unit1
stove	ストーブ	misc unit1
top (part)	じょうぶ	misc unit1
typhoon	たいふう	misc unit1
wet	ぬれた	misc unit1
width	はば	misc unit1
winter	ふゆ	misc unit1
an only child	ひとりっこ	family unit1 lesson2
aunt (honorific)	おばさん	family unit1 lesson2
aunt (your own)	おば	family unit1 lesson2
bachelorhood; single	どくしん	family unit1 lesson2
brothers	おとこのきょうだい	family unit1 lesson2
coexistence; living together	どうきょ	family unit1 lesson2
daughter	むすめ	family unit1 lesson2
divorce	りこん	family unit1 lesson2
father (honorific)	おとうさん	family unit1 lesson2
grandfather (honorific)	おじいさん	family unit1 lesson2
grandfather (your own)	そふ	family unit1 lesson2
grandmother (honorific)	おばあさん	family unit1 lesson2
grandmother (your own)	そぼ	family unit1 lesson2
grandparents	そふぼ	family unit1 lesson2
he; boyfriend	かれ	family unit1 lesson2
husband (honorific)	ごしゅじん	family unit1 lesson2
husband (your own)	おっと	family unit1 lesson2
mother (honorific)	おかあさん	family unit1 lesson2
nephew (honorific)	おいごさん	family unit1 lesson2
nephew (your own)	おい	family unit1 lesson2
niece (honorific)	めいごさん	family unit1 lesson2
niece (your own)	めい	family unit1 lesson2
older	としうえ	family unit1 lesson2
she; girlfriend	かのじょ	family unit1 lesson2
son	むすこ	family unit1 lesson2
to live; to make a living	くらす	family unit1 lesson2
to part from (other people), to be divided	わかれる	family unit1 lesson2
uncle (honorific)	おじさん	family unit1 lesson2
uncle (your own)	おじ	family unit1 lesson2
wife (honorific)	おくさん	family unit1 lesson2
wife (your own)	つま	family unit1 lesson2
younger	としした	family unit1 lesson2