mister, miss, madam	-san	lesson1 unit1
this person	kochira	lesson1 unit1
(topic partikel)	wa	lesson1 unit1
to be	desu	lesson1 unit1
to be (neg)	dewa arimasen/dewa nai desu	lesson1 unit1
to be (past)	deshita	lesson1 unit1
to be (past, neg)	dewa arimasen deshita/dewa nakata desu	lesson1 unit1
of (particle indicating belonging)	no	lesson1 unit1
attorney, lawyer	bengoshi	lesson1 unit1
how do you do	hajimemashite	lesson1 unit1
pleased to meet you	yoroshiku onegaishimasu	lesson1 unit1
department store	depāto	lesson1 unit1
Japan	Nihon	lesson1 unit1
China	Chūgoku	lesson1 unit1
Germany	Doitsu	lesson1 unit1
UK	Igirisu	lesson1 unit1
USA	Amerika	lesson1 unit1
Australia	ōsutoraria	lesson1 unit1
Thailand	Tai	lesson1 unit1
secretary	hisho	lesson1 unit1
student	gakusei	lesson1 unit1
engineer	enjinia	lesson1 unit1
(question particle)	ka	lesson1 unit1
yes	hai	lesson1 unit1
no	iie	lesson1 unit1
you	anata	lesson1 unit1
I	watashi	lesson1 unit1
bank	gīnko	lesson1 unit1
university, college	daigaku	lesson1 unit1
business card	meishi	lesson2 unit1
company	kaisha	lesson2 unit1
please (when giving)	dōzo	lesson2 unit1
thank you	dōmo arigatō gozaimasu	lesson2 unit1
this thing here	kore	lesson2 unit1
name	namae	lesson2 unit1
yes (less formal)	ee	lesson2 unit1
indeed	sō desu	lesson2 unit1
zero	zero/rei	lesson2 number unit1
one	ichi	lesson2 number unit1
two	ni	lesson2 number unit1
three	san	lesson2 number unit1
four	yon/shi	lesson2 number unit1
five	go	lesson2 number unit1
six	roku	lesson2 number unit1
seven	nana/shichi	lesson2 number unit1
eight	hachi	lesson2 number unit1
nine	kyū/ku	lesson2 number unit1
address	jūsho	lesson2 unit1
phone	denwa	lesson2 unit1
number	bangō	lesson2 unit1
e-mail address	mēru-adoresu	lesson2 unit1
cell phone	keitai	lesson2 unit1
umbrella	kasa	lesson2 unit1
book	hon	lesson2 unit1
newspaper	shimbun	lesson2 unit1
key	kagi	lesson2 unit1
watch, clock	tokei	lesson2 unit1
what	nan	lesson2 unit1
who	dare/donata	lesson1 unit1
embassy	taishikan	lesson2 unit1
what number	nan-ban	lesson2 unit1
country	kuni	lesson1 unit1
nationality	kokuseki	lesson1 unit1
to make a mistake	chigaimasu	lesson2 unit1
please (get me ...), I request	onegaishimasu	lesson1 unit1
receptionist	uketsuke	lesson1 unit1
please go ahead, please enter, please feel free	hai, dōzo	lesson1 unit1
datebook, small notebook, planner	techō	lesson2 unit1
I'm sorry	sumimasen	lesson2 unit1
one more time, please	mō ichi-do onegaishimasu	lesson2 unit1
more	mō	lesson2 unit1
one time	ichi-do	lesson2 unit1
excuse me	sumimasen	lesson3 unit2
what time	nan-ji	lesson3 unit2
o'clock	-ji	lesson3 unit2
woman	onna no hito	lesson3 unit2
female	onna	lesson3 unit2
person	hito	lesson3 unit2
nine o'clock	ku-ji	lesson3 unit2
fifty minutes	gojuppun/gojippun	lesson3 unit2
fifty	gojū	lesson3 unit2
minute	-fun/-pun	lesson3 unit2
from (particle/time &amp; place)	kara	lesson3 unit2
until, to (particle/place &amp; time)	made	lesson3 unit2
p.m., in the afternoon	gogo	lesson3 unit2
you're welcome	dō itashimashite	lesson3 unit2
supermarket	sūpā	lesson3 unit2
restaurant	resutoran	lesson3 unit2
post office	yūbinkyoku	lesson3 unit2
job, work	shigoto	lesson3 unit2
meeting	kaigi	lesson3 unit2
lunch break	hiru-yasumi	lesson3 unit2
noon	hiru	lesson3 unit2
rest, break	yasumi	lesson3 unit2
party	pātī	lesson3 unit2
movie	eiga	lesson3 unit2
half past (of time)	han	lesson3 unit2
a.m., in the morning	gozen	lesson3 unit2
morning	asa	lesson3 unit2
breakfast	asa-gohan	lesson3 unit2
evening	ban	lesson3 unit2
meal	gohan	lesson3 unit2
front desk (of a hotel)	furonto	lesson3 unit2
dinner	ban-gohan	lesson3 unit2
pool	pūru	lesson3 unit2
gym	jimu	lesson3 unit2
I see	sō desu ka	lesson3 unit2
shop, store, restaurant	mise	lesson4 unit2
may I help you?, welcome to the store	irasshaimase	lesson4 unit2
please show me	misete kudasai	lesson4 unit2
how much (money)	ikura	lesson4 unit2
yen	-en	lesson4 unit2
also, too, either (particle)	mo	lesson4 unit2
well then	ja	lesson4 unit2
please give me	kudasai	lesson4 unit2
hello, good afternoon	konnichiwa	lesson2 unit1
television	terebi	lesson4 unit2
radio	rajio	lesson4 unit2
(personal) computer	pasokon	lesson4 unit2
digital camera	dejikame	lesson4 unit2
video camera	bideo-kamera	lesson4 unit2
video	bideo	lesson4 unit2
camera	kamera	lesson4 unit2
CD player	CD-purēyā	lesson4 unit2
CD	CD (shīdī)	lesson4 unit2
that thing over there	are	lesson4 unit2
that thing close to you	sore	lesson4 unit2
magazine	zasshi	lesson4 unit2
DVD	DVD (dībuidī)	lesson4 unit2
mechanical pencil	shāpupenshiru	lesson4 unit2
ballpoint pen	bōrupen	lesson4 unit2
France	Furansu	lesson4 unit2
dictionary	jisho	lesson4 unit2
English (language)	Eigo	lesson4 unit2
suffix for languages	-go	lesson1 unit1
(credit) card	kādo	lesson4 unit2
is ... al right?	demo ii desu ka	lesson4 unit2
yes, it's fine	hai, kekkō desu	lesson4 unit2
thousand	sen	lesson4 number unit2
ten thousand	man	lesson4 number unit2
one hundred million (10<sup>8</sup>)	oku	lesson4 number unit2
one trillion (10<sup>12</sup>)	chō	lesson4 number unit2
decimal point	ten	lesson4 unit2
part (e.g. in 1/4)	bun	lesson4 unit2
ten	jū	lesson3 number unit2
one hundred	hyaku	lesson3 number unit2
... years old	-sai	misc
this ... close to me	kono	lesson5 unit2
that ... close to you	sono	lesson5 unit2
that ... over there	ano	lesson5 unit2
T-shirt	T-shatsu	lesson5 unit2
which one, which thing	dore	lesson5 unit2
blue	aoi	lesson5 unit2
red	akai	lesson5 unit2
(counter for flat objects)	-mai	lesson5 unit2
postcard	hagaki	lesson5 unit2
stamp	kitte	lesson5 unit2
black	kuroi	lesson5 unit2
beer	bīru	lesson5 unit2
apple	ringo	lesson5 unit2
large, big	ōkii	lesson5 unit2
small, little	chiisai	lesson5 unit2
Switzerland	Suisu	lesson5 unit2
(counter for long objects)	-hon	lesson5 unit2
car	kuruma	lesson5 unit2
Italy	Itaria	lesson5 unit2
where, which place	doko	lesson5 unit2
South Korea	Kankoku	lesson5 unit2
tangerine	mikan	lesson5 unit2
kilogram	kiro	lesson5 unit2
wine	wain	lesson5 unit2
coffee	kōhī	lesson5 unit2
cup	kappu	lesson5 unit2
towel	taoru	lesson5 unit2
cream puff	shūkurīmu	lesson5 unit2
good morning	ohayō gozaimasu	expressions
hello	konnichiwa	expressions
good evening	kombanwa	expressions
good night	oyasuminasai	expressions
good-bye	sayōnara	expressions
well then ...	dewa/ja mata	expressions
(when leaving the office or a meeting before other people)	o-sakini shitsureishimasu	expressions
so long (said to person leaving)	itterasshai	expressions
I'm back	tadaima	expressions
welcome home	okaerinasai	expressions
(said before eating a meal)	itadakimasu	expressions
congratulations	omedetō gozaimasu	expressions
(said after eating a meal)	gochisōsamadeshita	expressions
wait a moment, please	chotto matte kudasai	expressions
please, go ahead	dōzo o-sakini	expressions
take care, be careful	ki o tsukete	expressions
take care of yourself (used toward ill or injured person)	o-daijini	expressions
so long (said by person leaving)	ittekimasu	expressions
-ese, -ian (person from)	-jin	lesson1 unit1
now	ima	lesson3 unit2